หวัด	NN	O	B_CLS
หมู	NN	O	I_CLS
ยิ้ม	VV	O	E_CLS

เด็ก	NN	O	B_CLS
นักเรียน	NN	O	I_CLS
ชาว	FX	O	I_CLS
ญี่ปุ่น	NN	B_LOC	I_CLS
สวม	VV	O	I_CLS
หน้ากาก	NN	O	I_CLS
อนามัย	NN	O	I_CLS
ป้องกัน	VV	O	I_CLS
การ	FX	O	I_CLS
รับ	VV	O	E_CLS
และ	CC	O	B_CLS
แพร่	VV	O	I_CLS
เชื้อ	NN	O	E_CLS
ระหว่าง	CC	O	B_CLS
เดินทาง	VV	O	I_CLS
ไป	AV	O	I_CLS
ยัง	PS	O	I_CLS
วิหารเซนโซจิ	NN	O	I_CLS
_	PU	O	I_CLS
ใน	PS	O	I_CLS
กรุง	NN	B_LOC	I_CLS
โตเกียว	NN	E_LOC	I_CLS
_	PU	O	I_CLS
ประเทศ	NN	O	I_CLS
ญี่ปุ่น	NN	B_LOC	I_CLS
_	PU	O	I_CLS
เมื่อ	PS	O	I_CLS
วันที่	NN	B_DTM	I_CLS
_	PU	I_DTM	I_CLS
22	NU	I_DTM	I_CLS
_	PU	I_DTM	I_CLS
พฤษภาคม	NN	E_DTM	E_CLS

ซึ่ง	CC	O	B_CLS
เป็น	VV	O	I_CLS
วัน	CL	O	I_CLS
แรก	NU	O	E_CLS
ที่	CC	O	B_CLS
ทางการ	NN	O	I_CLS
ญี่ปุ่น	NN	B_LOC	I_CLS
ผ่อนคลาย	VV	O	I_CLS
มาตรการ	NN	O	I_CLS
เข้มงวด	VV	O	E_CLS
เพื่อ	CC	O	B_CLS
ป้องกัน	VV	O	I_CLS
การ	FX	O	I_CLS
แพร่	VV	O	I_CLS
ระบาด	VV	O	I_CLS
ของ	PS	O	I_CLS
เชื้อ	NN	O	I_CLS
ไวรัส	NN	O	I_CLS
ไข้	NN	O	I_CLS
หวัด	NN	O	I_CLS
ใหญ่	VV	O	I_CLS
_	PU	O	I_CLS
2009	NU	B_DTM	E_CLS
_	PU	O	O
เพราะ	CC	O	B_CLS
เกรง	VV	O	E_CLS
ว่า	CC	O	B_CLS
การ	FX	O	I_CLS
เข้มงวด	VV	O	I_CLS
จะ	AX	O	I_CLS
ส่ง	VV	O	I_CLS
ผล	NN	O	I_CLS
ทำลาย	VV	O	I_CLS
เศรษฐกิจ	NN	O	I_CLS
ของ	PS	O	I_CLS
ประเทศ	NN	O	I_CLS
_	PU	O	I_CLS
(	PU	O	I_CLS
รอยเตอร์	NN	B_ORG	I_CLS
)	PU	O	E_CLS

