เอทีเอ็ม	NN	O	B_CLS
ปลอด	VV	O	I_CLS
ภัย	NN	O	E_CLS

เอ็นซีอาร์	NN	B_ORG	B_CLS
_	PU	I_ORG	I_CLS
คอร์เปอร์เรชั่น	NN	I_ORG	I_CLS
_	PU	I_ORG	I_CLS
สหรัฐอเมริกา	NN	E_ORG	I_CLS
_	PU	O	I_CLS
ประกาศ	VV	O	I_CLS
ว่า	CC	O	E_CLS
_	PU	O	O
สามารถ	AX	O	B_CLS
ขาย	VV	O	I_CLS
ลิขสิทธิ์	NN	O	I_CLS
ซอฟต์แวร์	NN	O	E_CLS
เพื่อ	CC	O	B_CLS
ป้องกัน	VV	O	I_CLS
การ	FX	O	I_CLS
โจรกรรม	VV	O	I_CLS
ข้อมูล	NN	O	I_CLS
ทาง	NN	O	I_CLS
เอทีเอ็ม	NN	O	I_CLS
ให้	AX	O	I_CLS
สถาบัน	NN	O	I_CLS
การเงิน	NN	O	I_CLS
ทั่ว	PS	O	I_CLS
โลก	NN	O	I_CLS
ได้	AX	O	I_CLS
มาก	VV	O	I_CLS
กว่า	AV	O	I_CLS
_	PU	O	I_CLS
50,000	NU	B_MEA	I_CLS
_	PU	O	I_CLS
ลิขสิทธิ์	CL	B_MEA	E_CLS

ซอฟต์แวร์	NN	O	B_CLS
ดังกล่าว	AJ	O	I_CLS
มี	VV	O	I_CLS
ประสิทธิภาพ	NN	O	I_CLS
สูง	VV	O	I_CLS
สุด	AV	O	I_CLS
ป้องกัน	VV	O	I_CLS
การ	FX	O	I_CLS
เจาะ	VV	O	I_CLS
ข้อมูล	NN	O	I_CLS
โจรกรรม	NN	O	I_CLS
ทาง	NN	O	I_CLS
อิเล็กทรอนิกส์	NN	O	I_CLS
ผ่าน	VV	O	I_CLS
เทคโนโลยี	NN	O	I_CLS
กลั่นกรอง	VV	O	I_CLS
ข้อมูล	NN	O	I_CLS
โดยเฉพาะ	CC	O	I_CLS
กลโกง	NN	O	I_CLS
จาก	PS	O	I_CLS
ภายใน	PS	O	E_CLS

