รมว.	NN	B_DES	B_CLS
กลาโหม	NN	B_ORG	I_CLS
หนุน	VV	O	I_CLS
เช่า	VV	O	I_CLS
รถ	NN	O	I_CLS
เมล์	NN	O	I_CLS
เอ็นจีวี	NN	O	E_CLS
แต่	CC	O	B_CLS
รัฐบาล	NN	O	I_CLS
ต้อง	AX	O	I_CLS
แจง	VV	O	I_CLS
โปร่งใส	VV	O	E_CLS

วัน	NN	B_DTM	B_CLS
นี้	AJ	E_DTM	I_CLS
(	PU	O	I_CLS
4	NU	B_DTM	I_CLS
_	PU	I_DTM	I_CLS
มิ.ย.	NN	I_DTM	I_CLS
52	NU	E_DTM	I_CLS
)	PU	O	I_CLS
_	PU	O	I_CLS
พล.อ.	NN	B_DES	I_CLS
ประวิตร	NN	B_PER	I_CLS
วงษ์สุวรรณ	NN	I_PER	I_CLS
รมว.	NN	B_DES	I_CLS
กลาโหม	NN	B_ORG	I_CLS
_	PU	O	I_CLS
กล่าว	VV	O	I_CLS
ว่า	CC	O	I_CLS
_	PU	O	I_CLS
รัฐบาล	NN	O	I_CLS
และ	CC	O	I_CLS
กระทรวง	NN	B_ORG	I_CLS
คมนาคม	NN	E_ORG	I_CLS
_	PU	O	I_CLS
จะ	AX	O	I_CLS
ต้อง	AX	O	I_CLS
พิจารณา	VV	O	I_CLS
ใน	PS	O	I_CLS
ภาพรวม	NN	O	I_CLS
_	PU	O	I_CLS
ซึ่ง	CC	O	I_CLS
โครงการ	NN	O	I_CLS
ดังกล่าว	AJ	O	I_CLS
จะ	AX	O	I_CLS
ทำให้	CC	O	I_CLS
ประชาชน	NN	O	I_CLS
ได้	AX	O	I_CLS
รถ	NN	O	I_CLS
เมล์	NN	O	I_CLS
ใหม่	VV	O	E_CLS
_	PU	O	O
เพียงแต่	CC	O	B_CLS
ต้อง	AX	O	I_CLS
ชี้แจง	VV	O	I_CLS
ถึง	PS	O	I_CLS
วิธีการ	NN	O	E_CLS
ที่	CC	O	B_CLS
เหมาะสม	VV	O	E_CLS
_	PU	O	O
เพื่อ	CC	O	B_CLS
ให้	AX	O	I_CLS
ผู้	FX	O	I_CLS
บริโภค	VV	O	I_CLS
ได้	AX	O	I_CLS
ของ	PS	O	E_CLS
ที่	CC	O	B_CLS
ดี	VV	O	I_CLS
ที่สุด	AV	O	I_CLS
_	PU	O	I_CLS
ยืนยัน	VV	O	I_CLS
ไม่	NG	O	I_CLS
มีการ	FX	O	I_CLS
ยื้อ	VV	O	I_CLS
กัน	PR	O	I_CLS
แลกเปลี่ยน	VV	O	I_CLS
โครงการ	NN	O	E_CLS

