อภิสิทธิ์	NN	B_PER	B_CLS
จ่อ	VV	O	I_CLS
เสนอ	VV	O	I_CLS
รัฐสภาวิสามัญ	NN	O	I_CLS
ถก	VV	O	I_CLS
พรก.	VV	O	I_CLS
เงิน	NN	O	I_CLS
กู้	VV	O	I_CLS
พร้อม	CC	O	I_CLS
พรบ.	VV	O	I_CLS
งบ	NN	O	I_CLS
ฯ	PU	O	I_CLS
_	PU	O	I_CLS
53	NU	B_DTM	E_CLS

วัน	NN	B_DTM	B_CLS
นี้	AJ	E_DTM	I_CLS
(	PU	O	I_CLS
3	NU	B_DTM	I_CLS
_	PU	I_DTM	I_CLS
มิ.ย.	NN	I_DTM	I_CLS
52	NU	E_DTM	I_CLS
)	PU	O	I_CLS
_	PU	O	I_CLS
นาย	NN	B_TTL	I_CLS
อภิสิทธิ์	NN	B_PER	I_CLS
_	PU	I_PER	I_CLS
เวชชาชีวะ	NN	E_PER	I_CLS
_	PU	O	I_CLS
นายก	NN	B_DES	I_CLS
รัฐมนตรี	NN	E_DES	I_CLS
_	PU	O	I_CLS
กล่าว	VV	O	I_CLS
ถึง	PS	O	E_CLS
กรณีที่	CC	O	B_CLS
ศาล	NN	B_ORG	I_CLS
รัฐธรรมนูญ	NN	E_ORG	I_CLS
ได้	AX	O	I_CLS
พิจารณา	VV	O	I_CLS
_	PU	O	I_CLS
พ.ร.ก.	NN	B	I_CLS
ให้	AX	O	I_CLS
อำนาจ	NN	O	I_CLS
กระทรวง	NN	B_ORG	I_CLS
การ	FX	I_ORG	I_CLS
คลัง	NN	E_ORG	I_CLS
กู้	VV	O	I_CLS
เงิน	NN	O	E_CLS
_	PU	O	O
เพื่อ	CC	O	B_CLS
ฟื้นฟู	VV	O	E_CLS
และ	CC	O	B_CLS
เสริมสร้าง	VV	O	I_CLS
ความ	FX	O	I_CLS
มั่นคง	VV	O	I_CLS
ทาง	NN	O	I_CLS
เศรษฐกิจ	NN	O	I_CLS
_	PU	O	I_CLS
พ.ศ.	NN	B_DTM	I_CLS
2552	NU	E_DTM	I_CLS
_	PU	O	I_CLS
ไม่	NG	O	I_CLS
ขัด	VV	O	I_CLS
รัฐธรรมนูญ	NN	O	E_CLS
_	PU	O	O
ว่า	CC	O	B_CLS
_	PU	O	O
ขอ	VV	O	B_CLS
ขอบคุณ	VV	O	E_CLS
ที่	CC	O	B_CLS
การ	FX	O	I_CLS
พิจารณา	VV	O	I_CLS
เป็น	VV	O	I_CLS
ไป	AV	O	I_CLS
อย่าง	FX	O	I_CLS
รวดเร็ว	VV	O	E_CLS

ทั้งนี้	CC	O	B_CLS
ตั้งใจ	VV	O	E_CLS
ว่า	CC	O	B_CLS
จะ	AX	O	I_CLS
นำ	VV	O	I_CLS
เรื่อง	NN	O	I_CLS
ดังกล่าว	AJ	O	I_CLS
เข้า	VV	O	I_CLS
สู่	PS	O	I_CLS
การ	FX	O	I_CLS
พิจารณา	VV	O	I_CLS
ใน	PS	O	I_CLS
การ	FX	O	I_CLS
ประชุม	VV	O	I_CLS
รัฐสภา	NN	B_ORG	I_CLS
สมัย	NN	O	I_CLS
วิสามัญ	VV	O	E_CLS
_	PU	O	O
ที่	CC	O	B_CLS
จะ	AX	O	I_CLS
มีการ	FX	O	I_CLS
พิจารณา	VV	O	I_CLS
ร่าง	NN	O	I_CLS
_	PU	O	I_CLS
พ.ร.บ.	NN	B	I_CLS
งบประมาณ	NN	O	I_CLS
ราย	NN	O	I_CLS
จ่าย	VV	O	I_CLS
ประจำ	VV	O	I_CLS
ปี	NN	B_DTM	I_CLS
งบประมาณ	NN	I_DTM	I_CLS
_	PU	I_DTM	I_CLS
พ.ศ.	NN	I_DTM	I_CLS
2553	NU	E_DTM	E_CLS

